ttt ttt ttt 
n   n n n n
n   n n n n
n   nn  n n
ttt ttt ttt
n n n n n n
n n n n n n
n n n n n n
ttt t t ttt
sssss sssss
