nnn nnn nnn
  n n n n n
  n n n n n
  n n n n n
nnn n n nnn
  n n n n n
  n n n n n
  n n n n n
nnn nnn nnn
